132
8
77 	77 	77 	77 	77 	78 	79 	0  	0  	0  	0  	0  	0  	0  	0  	0  	0  	0  	0  	0  	0  	0  	0  	0  	0  	0  	0  	0  	0  0  0  0  0  0  0  0  0  0  0  0  0  0  0  0  0  0  0  0  0  0  0  0  0  0  0  0  0  0  0  0  0 0 0  0  0  0  0  0  0  0 0  0  0  0 0 0 0 0 0 0 0 0 36 0 0 0 0 0 0 0 0 0 0 0 0 0 0 0 0 0 0 0 0 0 0 0 0 0 0 0 0 0 0 0 0 36 0 0 0 0 0 0 0 0 0 37 37 37 31 30 30 31 
77 	77 	77 	77 	77 	108 109 0  	0  	0  	0  	0  	0  	0  	0  	0  	0  	0  	0  	0  	0  	0  	0  	0  	0  	0  	0  	0  	30 31 32 41  0  0  0  0  0  0  0  0  0  0  0  0  0  0  0  0  0  0  0  0  0  0  0  0  0  0  0  0  0 0 0  0  0  0  0  0  0  0 0  0  0  0 0 0 0 0 0 0 0 0 33 0 0 0 0 0 0 0 0 0 0 0 0 0 0 0 0 0 0 0 0 0 0 0 0 0 0 0 0 0 0 0 0 33 0 0 0 0 0 0 0 0 0 37 37 37 32 31 32 32 
77 	77 	77 	77 	77 	78 	79  0  	0  	0  	0  	0  	0  	0  	0  	0  	0  	0  	0  	0  	0  	0  	0  	0  	0  	0  	0  	0  	60 61 62 71 0  0  0  0  0  0  0  0  0  0  0  0  0  0  0  0  0  0  0  0  0  0  0  0  0  0  0  0  0 0 0  0  0  0  34 33 34 0 0  0  0  0 0 0 0 0 0 0 0 0 35 0 0 0 0 0 0 0 0 0 0 0 0 0 0 0 0 0 0 0 0 0 0 0 0 0 0 0 0 0 0 0 0 35 0 0 0 0 0 0 0 0 0 37 37 37 32 30 32 30 
77 	77 	77 	77 	77 	108 109 0  	0  	0  	0  	0  	0  	0  	0  	0  	0  	0  	0  	0  	0  	0  	0  	0  	0  	0  	0  	0  	90 91 32 32 31 0  0  0  0  0  0  0  0  0  0  0  0  0  0  0  0  0  0  0  0  0  0  0  0  0  0  0  0 0 34 33 34 0  0  35 0  0 0  0  0  0 0 0 0 0 0 0 0 0 0 0 0 0 0 0 0 0 0 0 0 0 0 0 0 0 0 0 0 0 0 0 0 0 35 0 0 0 0 0 0 0 0 0 0 0 0 0 0 0 0 0 0 37 37 37 31 30 32 32 
77 	77 	77 	77 	77 	78 	79 	0  	0  	0  	0  	0  	0  	0  	0  	0  	30 	31 	32 	33 	34 	35 	34 	35  31 	32 	33 	34  120 30 32 32 36 32 31 0  0  0  0  0  0  0  0  0  0  0  0  0  0  0  0  0  0  0  0  0  0  0  0  0  0 0 0  35 0  0  0  35 0  0 34 33 34 33 34 0 0 0 38 38 31 30 30 30 30 0 0 0 0 0 0 0 0 0 0 0 0 0 0 0 0 0 0 0 0 0 35 0 0 0 0 35 0 0 0 0 0 0 0 0 0 0 0 0 0 36 36 36 31 32 32 32 
77 	77 	77 	77 	77 	108 109 0  	0  	0  	0  	0  	0  	0  	0  	0  	60 	61 	62 	63 	64 	65 	66 	67 	61 	62 	63 	64 	150 32 30 30 30 30 32 31 0  0  0  0  0  0  0  0  0  0  0  0  0  0  0  30 32 32 34 34 33 34 33 31 0 0 0  35 0  0  0  35 0  0 0  35 0  35 0 0 0 0 37 0 0 0 0 0 0 0 0 0 3 33 34 33 34 33 34 0 0 0 0 0 0 0 38 0 0 35 33 34 0 0 0 35 0 0 0 0 34 33 34 33 34 32 32 31 32 30 32 32 32 32 31 32 
77 	77 	77 	77 	77 	78 	79 	30 	31 	32 	33 	34 	31 	32 	33 	31 	90 	91 	92 	93 	94 	95 	96 	97  91 	92 	93 	94  35 30 31 32 30 32 31 32 32 32 33 33 32 32 32 32 33 32 32 32 32 33 32 32 32 31 30 30 31 35 0  35 0  0 0 0  35 0  0  0  35 0  0 0  35 0  35 0 0 0 3 33 4 0 0 38 0 0 0 0 0 0 35 0 35 0 30 32 31 30 32 32 30 31 32 36 0 0 0 35 0 0 0 3 33 34 0 0 0 0 35 0 32 32 31 30 31 32 30 31 32 30 31 30 32 
77 	77 	77 	77 	77 	108 109 60 	61 	62 	63 	64 	61 	62 	63 	61 	120 121 122 123 124	125 126 127 121 122 123 124 31 32 30 30 32 32 31 31 30 30 32 30 32 31 32 30 32 31 30 31 32 31 32 30 31 31 32 32 0  35 0  0 0 0  35 0  0  0  35 0  0 0  35 0  35 0 0 0 0 35 0 0 0 33 0 0 0 0 0 0 35 0 30 31 32 32 31 32 32 30 32 30 32 32 32 32 32 35 0 0 0 0 35 0 0 0 0 0 32 30 32 31 31 32 32 31 32 30 32 32 30 32 31 
