132
15
151  151  166  167  168  166  168  72  72  73  73  151  151  151  151  151  151  151  151  151  151  151  151  151  151  151  151  151  151  151  151  151  151  151  151  151  151  151  151  151  151  151  151  151  151  151  151  151  151  151  151  151  151  151  151  151  151  151  151  151  151  151  151  151  151  151  151  151  151  151  151  151  151  151  151  151  151  151  151  151  151  151  151  151  151  151  151  151  151  151  151  151  151  151  151  151  151  151  151  151  151  151  151  151  151  151  151  151  151  151  151  151  151  151  151  151  151  151  151  151  151  151  151  151  151  151  151  151  151  151  151  151  
151  79  0  17  18  0  0  11  11  12  12  0  0  0  0  0  0  0  0  0  0  0  0  0  0  134  0  0  134  0  0  0  0  0  0  0  0  0  0  0  0  0  0  0  0  0  0  0  0  0  0  0  0  0  0  0  0  0  0  0  0  0  0  0  0  0  0  0  0  0  0  0  0  0  0  0  0  0  0  0  0  0  36  0  0  0  0  151  151  151  151  151  151  151  151  0  0  0  0  0  0  0  0  0  0  0  0  0  0  0  0  0  0  0  0  0  0  0  0  0  0  0  0  0  0  0  0  0  102  0  0  151  
151  109  0  0  0  0  0  0  0  0  0  0  0  0  0  0  0  0  0  0  0  0  0  0  0  134  0  0  134  0  0  0  0  0  0  0  0  0  0  0  0  0  0  0  0  0  0  0  0  0  0  0  0  0  0  0  0  0  0  0  0  0  0  0  0  0  0  0  0  0  0  0  0  0  0  0  0  0  0  0  0  0  36  0  0  0  0  0  0  0  0  0  0  0  0  0  0  0  0  0  0  0  0  0  0  0  0  0  0  0  0  0  0  0  0  0  0  0  0  0  0  0  0  0  0  0  0  0  102  0  0  151  
151  79  0  0  0  0  0  0  0  0  0  0  0  0  0  0  0  0  0  0  0  0  0  0  0  134  0  0  134  0  0  0  0  0  0  0  0  0  0  0  0  0  0  0  0  0  0  0  0  0  0  0  0  0  0  0  0  0  0  0  0  0  0  0  0  0  0  0  0  0  0  0  0  0  0  0  0  0  0  0  0  0  36  0  0  0  0  0  0  0  0  0  0  0  0  0  0  0  0  0  0  0  0  0  0  0  0  0  0  0  0  0  0  0  0  0  0  0  0  0  0  0  0  0  0  0  0  0  102  0  0  151  
151  109  0  0  0  0  0  0  0  0  0  0  0  0  0  0  0  0  0  0  0  0  0  0  0  134  0  0  134  0  0  0  0  0  0  0  0  0  0  0  0  0  0  0  0  0  0  0  0  0  0  0  0  0  0  0  0  0  0  0  0  0  0  0  0  0  0  0  0  0  0  0  0  0  0  0  0  0  0  0  0  0  36  0  0  0  0  0  0  0  0  0  0  0  0  0  0  0  0  0  0  0  0  0  0  0  0  92  0  0  0  0  0  0  0  0  0  0  0  102  102  102  102  102  102  102  0  0  102  0  0  151  
151  79  0  0  0  0  0  0  0  0  0  0  0  0  0  0  0  0  0  0  0  0  0  0  0  134  0  0  134  0  0  0  0  0  0  0  0  0  0  0  0  0  0  0  0  0  0  0  0  0  0  0  0  0  0  0  0  0  0  0  0  0  0  0  0  0  0  0  0  0  0  0  0  0  0  0  0  0  0  0  0  0  36  0  0  0  0  0  0  0  0  0  0  0  0  0  0  0  0  0  0  0  92  0  0  0  0  92  0  0  0  0  0  0  0  0  0  0  0  102  0  0  0  0  0  0  0  0  102  0  0  151  
151  109  67  68  69  70  71  0  0  0  0  0  0  0  0  0  0  0  0  0  0  0  0  0  0  134  0  0  134  0  0  0  0  0  0  0  0  0  0  0  0  0  0  0  0  0  0  0  0  0  0  0  0  0  0  0  0  0  0  0  0  0  0  0  0  0  0  0  0  0  0  0  0  0  0  0  0  0  0  0  0  0  36  0  0  0  0  0  0  0  0  0  0  0  0  0  0  0  0  0  0  0  92  0  0  0  0  92  0  0  0  0  0  0  0  0  102  102  102  102  0  0  0  0  0  0  0  0  102  0  0  151  
151  96  97  98  99  100  101  0  0  0  0  0  0  0  0  0  0  0  0  0  0  0  0  0  0  134  0  0  134  0  0  0  0  0  0  0  0  0  0  0  0  0  0  0  0  0  0  0  0  0  0  0  0  0  0  0  0  0  0  0  0  0  0  0  0  0  0  0  0  0  0  0  0  0  0  0  0  0  0  0  0  0  36  0  0  0  0  0  0  0  0  0  0  0  0  0  0  0  0  0  0  0  92  0  0  0  0  92  0  0  0  0  0  0  0  0  102  0  0  0  0  0  0  0  0  0  0  0  102  0  0  151  
151  125  126  127  129  130  131  0  0  0  0  0  0  0  0  0  0  0  0  0  0  0  0  0  0  134  0  0  134  0  0  0  0  0  0  0  0  0  0  0  0  0  0  0  0  0  0  0  0  0  0  0  0  0  0  0  0  0  0  0  0  0  0  0  0  0  0  0  0  0  0  0  0  0  0  0  0  0  0  0  0  0  36  0  0  0  0  0  0  0  0  0  0  0  0  0  0  0  92  0  0  0  92  0  0  0  0  92  0  0  0  0  0  0  0  0  102  0  0  0  0  0  0  0  0  0  0  0  102  0  0  151  
151  151  151  151  151  160  161  0  0  0  0  0  0  0  0  0  0  0  0  0  0  0  0  0  0  134  30  31  134  0  0  0  0  0  0  0  0  0  0  0  0  0  0  0  0  0  0  0  0  0  0  0  0  0  0  0  0  0  0  0  0  0  0  0  0  0  0  0  0  0  0  0  0  0  0  0  0  0  0  0  0  0  36  0  0  0  0  0  0  0  0  0  0  0  0  0  0  0  93  0  0  0  92  0  0  0  0  92  0  0  0  0  0  102  102  0  102  0  0  0  0  0  0  0  0  0  0  0  102  0  0  151  
151  151  151  151  151  160  131  0  0  0  0  0  0  0  0  0  0  0  0  0  0  0  0  0  30  31  60  61  62  63  64  65  66  67  68  69  70  65  66  64  65  66  64  65  66  64  65  66  64  65  66  69  70  71  0  0  0  0  60  61  62  63  64  65  66  64  65  66  64  70  71  0  0  0  0  0  0  0  0  0  0  0  36  0  0  0  0  0  0  0  0  0  0  0  92  0  0  0  93  0  0  0  92  0  0  0  0  92  0  0  0  0  0  102  102  102  102  0  0  0  0  0  0  0  0  0  0  0  102  0  0  151  
151  151  151  151  151  160  161  0  0  0  0  0  0  0  0  0  0  0  0  0  0  0  30  31  60  61  90  151  151  151  151  151  151  151  151  151  151  151  151  151  151  151  151  151  151  151  151  151  151  151  151  151  151  101  0  0  0  0  90  151  151  151  151  151  151  151  151  151  151  151  101  70  71  0  0  0  0  0  0  0  0  0  36  0  0  0  0  0  0  0  0  0  0  0  93  0  0  0  93  0  0  0  92  0  0  0  0  92  0  0  0  0  0  102  0  0  0  0  0  0  0  0  0  0  0  0  0  0  0  0  0  151  
151  151  151  151  151  160  131  0  0  0  0  0  0  0  0  0  0  0  0  0  30  31  60  61  90  151  151  151  151  151  151  151  151  151  151  151  151  151  151  151  151  151  151  151  151  151  151  151  151  151  151  151  151  131  0  0  0  0  120  151  151  151  151  151  151  151  151  151  151  151  151  151  101  70  71  0  0  0  0  0  0  0  36  0  0  0  0  0  0  0  0  0  0  0  94  0  0  0  93  0  0  0  92  0  0  0  0  92  0  0  0  102  102  102  0  0  0  0  0  0  0  0  0  0  0  0  0  0  0  0  0  151  
151  151  151  151  151  160  161  0  0  0  0  0  0  0  0  0  0  0  0  0  60  61  90  151  151  151  151  151  151  151  151  151  151  151  151  151  151  151  151  151  151  151  151  151  151  151  151  151  151  151  151  151  151  161  0  0  0  0  150  151  151  151  151  151  151  151  151  151  151  151  151  151  151  151  101  70  71  0  0  0  0  0  36  0  0  0  0  0  0  0  0  0  0  0  96  0  0  0  93  0  0  0  92  0  0  0  0  92  0  0  0  102  0  0  0  0  0  0  0  0  0  0  0  0  0  0  0  0  0  0  0  151  
155  156  157  158  159  160  98  61  62  63  64  65  66  67  68  69  70  65  66  67  90  151  151  151  151  151  151  151  151  151  151  151  151  151  151  151  151  151  151  151  151  151  151  151  151  151  151  151  151  151  151  151  151  131  0  0  0  0  120  151  151  151  151  151  151  151  151  151  151  151  151  151  151  151  151  151  151  61  62  63  64  65  66  151  151  151  151  151  151  151  151  151  151  151  151  151  151  151  151  151  151  151  151  151  151  151  151  151  151  151  151  151  151  151  151  151  151  151  151  151  151  151  151  151  151  151  151  151  151  151  151  151  
